[Options]
AddToInfo=1
Caption=Interests
CityName=Montreal
StringToAdd='Interests:'

[1 GREEN ANGRIGNON - HONORЙ-BEAUGRAND]
Angrignon=Parc Angrignon
Monk=Centre hospitalier Ville Йmard\nЙcole Dollard-des-Ormeaux\nЙcole St-Jean-de-Matha\nЙcole Honorй-Mercier
Jolicoeur=Acadйmie Argyle\nCentre d'orientation et de formation des immigrants (C.O.F.I.)\nЙcole Coeur-Immaculй-de-Marie\nCentre St-Raphaлl\nParc de-la-Vйrendrye
Verdun=St. Willibrord Hospitality Center\nHфtel de ville de Verdun\nЙcole Levis-Sauvй\nRйgie du logement\nCentre communautaire Marcel-Giroux
De L'Йglise=Santй et Bien-кtre social Canada\nCentre de services sociaux du Montrйal Mйtropolitain b.s.s. Sud-Ouest\nCentre hospitalier de Verdun\nAuditorium de Verdun\nЙcole Notre-Dame-des-Sept-Douleurs\nParc Thйrien
LaSalle=Centre d'accueil Rйal-Morel\nPolyvalente Mgr Richard\nЙcole Notre-Dame-de-la-Paix
Charlevoix=Centre St-Charles\nCentre d'accueil Louis-Riel\nCarrefour d'йducation populaire\nServices juridiques communautaires de Pointe-St-Charles et de La Petite Bourgogne\nCentre St-Columba House\nService d'immatriculation des vйhicules automobiles
Lionel-Groulx=Йglise St-Irйnйe\nFoyer Hongrois\nUnion United Church
Atwater=Place Alexis-Nihon\nHфpital Reddy Memorial\nHфpital de Montrйal pour enfant\nWestmount Square\nCollиge Dawson
Guy-Concordia=Canadian Centre for\nArchitecture\nCLSC Mйtro\nFaubourg Sainte-Catherine\nTour Guy\nConcordia University
Peel=Les Cours Mont-Royal\nAetna Canada\nLe 2000 Peel Iata\nMaison Sodarcan\nЙdifice Dominion Square\nYMCA de Montrйal
McGill=Centre Eaton\nЙpargne placements Quйbec\nMaison des Coopйrants\nPlace Montreal Trust\nPlace London Life\nPromenade de la Cathйdrale\nLe Centre 2020 University\nLa Baie\nMaison Simons\nMcGill University
Place des Arts=Complexe Desjardins\nLe Directeur de l'йtat civil\n(De Bleury Nord Exit)\nGovernment of Canada\nHфtel Wyndham Montrйal\nHydro-Quйbec\nMusйe d'art contemporain\nPlace des Arts\nRйgie de l'assurance maladie du Quйbec\n(De Bleury Nord Exit)\nUniversitй du Quйbec а Montrйal (UQAM)\npavillon Prйsident-Kennedy\npavillon Chimie et biochimie\npavillon Arts IV\npavillon Sherbrooke
Saint-Laurent=Habitation Jeanne-Mance\nUQAM pavillon Ste-Catherine\nCйgep du Vieux-Montrйal\nCECI (Centre canadien d'йtudes et de coopйration internationale)\nMonument National (Йcole nationale de thйвtre)
Berri-UQAM=STM's Customer Services Centre\nCйgep du Vieux-Montrйal\nCinйma Quartier Latin\nCinйmathиque Quйbecoise\nCinйRobothиque (NFB)\nLe Quartier latin\nPlace Dupuis\nRue Saint-Denis\nStation centrale d'autobus (Formerly Terminus Voyageur)\nThйвtre St-Denis\nUniversitй du Quйbec а Montrйal
Beaudry=Association coopйrative d'йconomie familliale\nCentre Travail Quйbec\nMaison Radio-Canada
Papineau=Tйlй-Mйtropole\nSonolab\nЙdifice de la sйcurite publique\nConfйdйration des syndicats nationaux\nTйlй-Quйbec\nTйlйport de Montrйal
Frontenac=Place Frontenac\nMaison de la culture du Parc Frontenac\nЙcole Gйdйon-Ouimet\nЙcole Jean-Baptiste-Meilleur\nЙcole St-Anselme\nParc et Jardins communautaires Mйdйric-Martin
Prйfontaine=Centre hospitalier J.-Henri-Charbonneau\nCentre d'achats Maisonneuve\nSociйtй canadienne de la Croix-Rouge\nArйna et Parc Raymond-Prйfontaine\nInstitut Teccart\nЙcole Notre-Dame de l'Assomption
Joliette=Cйgep de Maisonneuve\nCLSC Hochelaga Maisonneuve\nLoisirs Notre-Dame de l'Assomption\nЙcole Ste-Jeanne-d'Arc\nParc Lalancette
Pie-IX=Stade Olympique\nBiodфme\nJardin botanique de Montrйal\nLe chвteau Dufresne\nHфpital St-Albert-le-Grand\nCentre Irйnйe-Lussier
Viau=Stade Olympique\nBiodфme\nArйna Maurice-Richard\nCentre Pierre-Charbonneau\nArйna YMCA\nParc Maisonneuve
Assomption=CLSC Olivier-Guimond\nHфpital Maisonneuve-Rosemont\nЙcole Marguerite-de-la-Jemmerais\nCentre d'accueil Foyer Rousselot\nComplexe Raycom\nLe Village Olympique
Cadillac=Centre hospitalier Grace Dart\nBanque fйdйrale de dйveloppement\nBureau du commissaire du travail\nService des sports et loisirs
Langelier=Centre commercial Domaine\nCentre d'emploi du Canada\nBibliothиque Langelier\nЙcole St-Donat\nЙcole Mgr Harold-Doran
Radisson=Place Versailles\nCentre de rйadaptation Lucie-Bruneau\nHфpital Louis Hippolyte-Lafontaine
Honorй-Beaugrand=Centre Champlain\nCentre hospitalier juif de l'Espйrance\nЙcole Mont-St-Antoine
                                         
[2 ORANGE CФTE-VERTU - MONTMORENCY]
Cфte-Vertu=Les galeries Norgate, shopping centre\nCйgep Vanier, 821, boul. Sainte-Croix\nCLSC Saint-Laurent, 1055, boul. Saite-Croix
Du Collиge=Cйgep St-Laurent\nCйgep Vanier\nЙcole Laurentide\nЙcole Hйbert\nMusйe d'art de Saint-Laurent
De La Savane=T.M.R. Shopping Centre
Namur=Hippodrome de Montrйal\n(formerly Blue Bonnets Racetrack)\nAMT's park-and\nride facility\nSPCA (\nface="Arial, Helvetica, sans-serif" size="2">Society for the Prevention of Cruelty to\nAnimals)
Plamondon=Centre commercial Van Horne\nAcadйmie Shadd\nЙcole St-Pascal Baylon\nЙcole Coronation\nЙcole Northmount\nCollиge rabbinique du Canada
Cфte-Sainte-Catherine=Hфpital gйnйral juif\nCentre communautaire juif\nCommunautй Sйpharade du Quйbec - Centre d'accueil et d'information\nGrand rabbinat du Quйbec\nTalmud Torahs unis de Montrйal
Snowdon=Bibliothиque Notre-Dame-de-Grвce
Villa-Maria=Йcole Villa-Maria\nЙcole Notre-Dame-de-Grвce\nЙcole Marymount
Vendфme=Centre St-Raymond\nComplexe de santй Reine Йlizabeth
Place-St-Henri=Йcole Polyvalente St-Henri\nЙcole Ludger-Duvernay\nCollиge Dawson\nInstitut technique Aviron\nAide juridique St-Henri
Lionel-Groulx=Йglise St-Irйnйe\nFoyer Hongrois\nUnion United Church
Georges-Vanier=Centre communautaire des Noirs\nCLSC St-Henri\nCentre communautaire Bon Pasteur
Lucien-l'Allier=Centre d'immigration du Canada\nCanadian Pacific Railway (head office)\nBell Centre\nGare Lucien-L'Allier - AMT's commuter trains\nUniversitй Concordia's Visual Arts Building
Bonaventure=Access to the Underground Montrйal\nMarie-Reine-du-Monde Cathedral\nCanadian Pacific Railway (head office)\nBell Centre\nЙcole de technologie supйrieure\nCentral Station - Via Rail Canada\nGare Lucien-L'Allier - AMT's commuter trains\nWindsor Station\nLe Chвteau Champlain Hotel\nLe 1000 de La Gauchetiиre\nICAO (International Civil Aviation Organization)\nPlace Bonaventure\nPlace du Canada\nPlace Ville-Marie\nCity of Montrйal's Planetarium\nSTM (Head office)
Square-Victoria=Centre de commerce mondial de Montrйal (accиs intйrieur)\nLe Curateur public, 600, boul. Renй-Lйvesque\nPlace de la Citй internationale (accиs intйrieur)\nTour Banque Nationale (accиs intйrieur)\nTour Bell (accиs intйrieur)\nTour de la Bourse (accиs intйrieur)\nHфtel Delta Centre-ville (accиs intйrieur)\nHфtel Inter-continental (accиs intйrieur)\nPlace Victoria
Place-d'Armes=Palais des congrиs\nComplexe Guy-Favreau\nBanque de Montrйal (siиge social)\nPalais de justice\nJournal La presse\nJournal The Gazette\nHфtel Intercontinental
Champ-de-Mars=Montreal City Hall\nMunicipal Court\nLe 333 St-Antoine (Ville de Montrйal)\nHфpital St-Charles-Borromйe\nHфpital St-Luc
Berri-UQAM=STM's Customer Services Centre\nCйgep du Vieux-Montrйal\nCinйma Quartier Latin\nCinйmathиque Quйbecoise\nCinйRobothиque (NFB)\nLe Quartier latin\nPlace Dupuis\nRue Saint-Denis\nStation centrale d'autobus (Formerly Terminus Voyageur)\nThйвtre St-Denis\nUniversitй du Quйbec а Montrйal
Sherbrooke=Йdifice C.H.Q. Gouvernement du Quйbec - Bureau des services sociaux Centre-Ville\nЙcole Cherrier\nHoliday Inn\nInstitut de tourisme et d'hфtellerie du Quйbec\nRue Saint-Denis
Mont-Royal=Avenue du Mont-Royal\nCentre communautaire Projet Changement\nЙcole Louis H. Lafontaine Arc-en-ciel\nLes jeunesses musicales du Canada\nMaison de la culture et bibliothиque Plateau Mont-Royal\nRue Saint-Denis\nTйluq (Universitй du Quйbec)
Laurier=Centre Champagnat (CSDM)\nЙcole Laurier\nЙcole nationale de thйвtre\nЙcole supйrieure de la danse du Quйbec\nPlaza Laurier\nTйluq (Universitй du Quйbec)
Rosemont=STM's Centre de transport Saint-Denis\nAide Juridique (Place de la mode)\nЙcole des mйtiers de l'automobile\nCour du Quйbec (Chambre de la jeunesse)\nCentre d'accueil Gouin-Rosemont
Beaubien=Acadйmie Ste-Anne\nCLSC La Petite Patrie\nCour de la citoyennetй canadienne\nЙcole La Mennais\nPlaza St-Hubert
Jean-Talon=Marchй Jean-Talon\nPlaza St-Hubert\nTour Jean-Talon
Jarry=Centre d'emploi du Canada\nЙcole Hйlиne-Boulй
Crйmazie=Conseil scolaire de l'оle de Montrйal\nCommunautйs culturelles et immigration du Quйbec\nЙcole St-Gйrard\nGouvernement du Quйbec - Centre administratif
Sauvй=Centre d'accueil Louvain\nЙcole Marie-Anne\nЙcole Fernand-Seguin\nЙcole Christ-Roi\nMinistиre des transports
Henri-Bourassa=Arйna Ahuntsic : 10560, rue Saint-Hubert\nBibliothиque Ahuntsic : 10300, rue Lajeunesse\nCйgep de Bois-de-Boulogne (Bus 164 or 171)\nMaison de la culture Ahuntsic-Cartierville : 10300, rue Lajeunesse\nParc Ahuntsic Terminus Laval (Interior access)
                                         
[3 BLUE SNOWDON - SAINT-MICHEL]
Snowdon=Bibliothиque Notre-Dame-de-Grвce
Cфte-des-Neiges=Centre hospitalier de St. Mary\nMaison de la culture Cфte-des-Neiges\nCentre communautaire de la Cфte-des-Neiges\nЙcole Notre-Dame-des-Neiges\nCollиge Notre-Dame\nOratoire St-Joseph
Universitй-de-Montrйal=Universitй de Montrйal\nЙcole Polytechnique de Montrйal\nЙcole des Hautes Йtudes Commerciales\nCollиge Jean-de-Brйbeuf\nHфpital Ste-Justine
Йdouard-Montpetit=CEPSUM\nЙcole de musique Vincent D'Indy\nUniversitй de Montrйal pavillon Marie-Victorin\nAcadйmie Saint-Germain\nSalle Claude-Champagne
Outremont=Collиge Stanislas\nЙcole Guy-Drummond\nЙcole Bais Esther\nTravail-Quйbec centre d'Outremont
Acadie=Centre commercial Place L'Acadie-Beaumont\nClinique Renй-Laennec
Parc=Tйlйvision Quatre Saisons\nCLSC Parc Extension\nParc Jarry
De Castelnau=Parc Jarry\nЙcole Sainte-Cйcile\nMarchй Jean-Talon
Jean-Talon=Marchй Jean-Talon\nPlaza St-Hubert\nTour Jean-Talon
Fabre=Hфpital Jean-Talon\nЙcole de Roberval\nCentre d'accueil Christophe-Colomb\nЙcole Saint-Gabriel-Lalemant
D'Iberville=Йcole St-Barthйlйmy\nCentre des loisirs St-Barthйlйmy\nЙcole St-Mathieu
Saint-Michel=Bibliothиque Saint-Michel\nCentre administratif - Ville de Montrйal\nЙcole Joseph-Franзois-Perrault\nЙcole John F Kennedy\nParc Franзois-Perrault
                                         
[4 YELLOW BERRI-UQAM - LONGUEUIL]
Berri-UQAM=STM's Customer Services Centre\nCйgep du Vieux-Montrйal\nCinйma Quartier Latin\nCinйmathиque Quйbecoise\nCinйRobothиque (NFB)\nLe Quartier latin\nPlace Dupuis\nRue Saint-Denis\nStation centrale d'autobus (Formerly Terminus Voyageur)\nThйвtre St-Denis\nUniversitй du Quйbec а Montrйal
Jean-Drapeau=Biosphиre\nLe Casino de Montrйal\nLa Ronde\nParc\nJean-Drapeau\nRestaurant\nHйlиne-de-Champlain\nStewart Museum at the Fort on\nОle Sainte-Hйlиne\nThйвtre de la Poudriиre
Longueuil=Complexe Bienville\nComplexe St-Charles\nЙdifice Port-de-mer\nSandman Montreal-Longueuil Hotel\nTerminus Longueuil (RTL -\nRйseau de transport de Longueuil)\nUniversitй de Sherbrooke
