[Options]
AddToInfo=1
Caption=Схема
CityName=Киев
Type=Image

[Святошинско-Броварская]
Академгородок=Akademgorodok.vec
Житомирская=Zhitomirskaya.vec
Святошин=Sviatoshin.vec
Нивки=Nivki.vec
Берестейская=Beresteyskaya.vec
Шулявская=Shulyavskaya.vec
Политехнический институт=Politex.vec
Вокзальная=Vokzalnaya.vec
Университет=Universitet.vec
Театральная=ZVorota-Teatralnaya.vec
Крещатик=Kreschatik-Maidan.vec
Арсенальная=Arsenalnaya.vec
Днепр=Dnepr.vec
Гидропарк=Gidropark.vec
Левобережная=Levoberezhnaya.vec
Дарница=Darnica.vec
Черниговская=Chernigovskaya.vec
Лесная=Lesnaya.vec

[Оболонско-Теремковская]
Героев Днепра=GeroivDnepra.vec
Минская=Minskaya.vec
Оболонь=Obolon.vec
Почайна=Pochaina.vec
Тараса Шевченко=TarasaShevchenko.vec
Контрактовая площадь=KontraktovayaPl.vec
Почтовая площадь=PochtovayaPloshad.vec
Площадь Независимости=Kreschatik-Maidan.vec
Площадь Льва Толстого=DvorecSporta-LvaTolstogo.vec
Олимпийская=Olimpiyskaya.vec
Дворец "Украина"=DvoretsUkraina.vec
Лыбедская=Lybedskaya.vec
Демиевская=Demievskaya.vec
Голосеевская=Goloseevskaya.vec
Васильковская=Vasilkovskaya.vec
Выставочный центр=VystavochnyCentr.vec
Ипподром=Ippodrom.vec
Теремки=Teremki.vec

[Сырецко-Печерская]
Сырец=Syrets.vec
Дорогожичи=Dorogozhichi.vec
Лукьяновская=Lukyanovskaya.vec
Золотые ворота=ZVorota-Teatralnaya.vec
Дворец спорта=DvorecSporta-LvaTolstogo.vec
Кловская=Klovskaya.vec
Печерская=Pecherskaya.vec
Дружбы народов=DruzhbyNarodov.vec
Выдубичи=Vydubichi.vec
Славутич=Slavutich.vec
Осокорки=Osokorki.vec
Позняки=Poznyaki.vec
Харьковская=Kharkovskaya.vec
Вырлица=Vyrlitsa.vec
Бориспольская=Borispolskaya.vec
Красный хутор=KrasnyHutor.vec