[Options]
AddToInfo=1
Caption=Схема
CityName=Санкт-Петербург
Type=Image

[1]
Девяткино=Devyatkino.vec
Гражданский проспект=GrazhdanskyPr.vec
Академическая=Akademicheskaya.vec
Политехническая=Polytech.vec
Площадь Мужества=PlMuzhestva.vec
Лесная=Lesnaya.vec
Выборгская=Vyborgskaya.vec
Площадь Ленина=PlLenina.vec
Чернышевская=Chernyshevskaya.vec
Площадь Восстания=PlVosstania-Mayakovskaya.vec
Владимирская=Vladimirskaya-Dostoevskaya.vec
Пушкинская=PushkinskayaZvenigorodskaya.vec
Технологический институт-I=TechInstitut.vec
Балтийская=Baltiyskaya.vec
Нарвская=Narvskaya.vec
Кировский завод=KirovskyZavod.vec
Автово=Avtovo.vec
Ленинский проспект=LeninskyPr.vec
Проспект Ветеранов=PrVeteranov.vec

[2]
Парнас=Parnas.vec
Проспект Просвещения=PrProsvescheniya.vec
Озерки=Ozerki.vec
Удельная=Udelnaya.vec
Пионерская=Pionerskaya.vec
Чёрная речка=ChernayaRechka.vec
Петроградская=Petrogradskaya.vec
Горьковская=Gorkovskaya.vec
Невский проспект=NevskiPr-GostinyDvor.vec
Сенная площадь=Sadovaya-SennayaPl.vec
Технологический институт-II=TechInstitut.vec
Фрунзенская=Frunzenskaya.vec
Московские ворота=MoskVorota.vec
Электросила=Electrosila.vec
Парк Победы=ParkPobedy.vec
Московская=Moskovskaya.vec
Звёздная=Zvezdnaya.vec
Купчино=Kupchino.vec

[3]
Приморская=Primorskaya.vec
Василеостровская=Vasileostrovskaya.vec
Гостиный двор=NevskiPr-GostinyDvor.vec
Маяковская=PlVosstania-Mayakovskaya.vec
Площадь Александра Невского-I=AleksandraNevskogo.vec
Елизаровская=Elizarovskaya.vec
Ломоносовская=Lomonosovskaya.vec
Пролетарская=Proletarskaya.vec
Обухово=Obukhovo.vec
Рыбацкое=Rybatskoe.vec

[4]
Спасская=Sadovaya-SennayaPl.vec
Достоевская=Vladimirskaya-Dostoevskaya.vec
Лиговский проспект=LigovskiyPr.vec
Площадь Александра Невского-II=AleksandraNevskogo.vec
Новочеркасская=Novocherkasskaya.vec
Ладожская=Ladozhskaya.vec
Проспект Большевиков=PrBolshevikov.vec
Улица Дыбенко=UlDybenko.vec

[5]
Комендантский проспект=KomendantskyPr.vec
Старая Деревня=StarayaDerevnya.vec
Крестовский остров=KrestovskiyOstrov.vec
Чкаловская=Chkalovskaya.vec
Спортивная=Sportivnaya.vec
Адмиралтейская=Admiralteyskaya.vec
Садовая=Sadovaya-SennayaPl.vec
Звенигородская=PushkinskayaZvenigorodskaya.vec
Обводный канал=ObvodnyCanal.vec
Волковская=Volkovskaya.vec
Бухарестская=Buharestskaya.vec
Международная=Mezhdunarodnaya.vec

[6]
Путиловская=KirovskyZavod.vec
