[Options]
AddToInfo=1
Caption=Названия
CityName=Ташкент
StringToAdd='  '

[Chilonzor]
Olmazor=(Олмазор)\nПрежние названия: Sobir Rahimov (Сабира Рахимова) - до 06.11.2010.
Chilonzor=(Чиланзар)
Mirzo Ulug'bek=(Мирза Улугбек)\nПрежние названия: 50 Лет СССР
Novza=(Новза)\nПрежние названия: Hamza - до 16 июня 2015.
Milliy Bog'=(Миллий бог)\nРусский перевод: Национальный сад\nПрежние названия: Комсомольская, Yoshlik (Ёшлик, Молодёжная)
Bunyodkor=(Бунёдкор: созидатель, творец)\nПрежние названия: Xalqlar Do'stligi (Халклар дустлиги, русский перевод: Дружба народов) - до 06.08.08
Paxtakor=(Пахтакор)\nРусский перевод: Хлопкороб
Mustaqillik Maydoni=(Мустакиллик майдони)\nРусский перевод: Площадь Независимости\nПрежние названия: Площадь Ленина
Amir Temur Xiyoboni=(Амир Тимур хиёбони)\nРусский перевод: Сквер Амира Тимура\nПрежние названия: Октябрьской революции, Маркази хиёбони (Центральный сквер)
Hamid Olimjon=(Хамид Алимджан)
Pushkin=(Пушкин)
Buyuk Ipak Yo'li=(Буюк Ипак юли)\nРусский перевод: Великий Шёлковый путь \nПрежние названия: Максима Горького

[O'zbekiston]
Beruniy=(Беруни)
Tinchlik=(Тинчлик)\nРусский перевод: Мир
Chorsu=(Чорсу)
G'afur G'ulom=(Гафур Гулям)
Alisher Navoiy=(Алишер Навои)
O'zbekiston=(Узбекистан)
Kosmonavtlar=(Космонавтлар)\nРусский перевод: Космонавтов\nПрежнее название - Проспект Космонавтов (Космонавтлар проспекти)
Oybek=(Айбек)
Toshkent=(Ташкент)
Mashinasozlar=(Машинасозлар)\nРусский перевод: Машиностроителей\nПрежние названия: Ташсельмаш
Do'stlik=(Дружба)

[Yunusobod]
Ming O'rik=(Минг Урик)\nРусский перевод - Тысяча Урючин\nПроектное название - "Лахути"
Yunus Rajabiy=(Юнус Ражаби)\nПроектное название - "Первомайская"
Abdulla Qodiriy=(Абдулла Кодири)\nПроектное название - "Алайский рынок"
Minor=(Минор)\nПроектное название - "Имени Кирова"
Bodomzor=(Бадамзар)\nРусский перевод - Фисташковая роща\nПроектное название - "ВДНХ"
Shahriston=(Шахристан)\nПрежние названия: Habib Abdullayev - до 16 июня 2015.\nПроектное название - "Шахристанская"
Yunus-Obod=(Юнусабад)
Turkiston=(Туркестан)\nПроектное название - "Тургуна Мирзаева"

